Kennan Blevins|et.magnis.dis@vulputaterisusa.com|Madagascar
Tamekah Weber|egestas.urna@Donectincidunt.edu|Gibraltar
Tobias Fuentes|non@euismod.net|Åland Islands
Shana Phelps|consequat.nec.mollis@Nam.net|Palau
Chastity Griffith|tortor@dolorNulla.edu|Angola
Beatrice Irwin|mi.ac.mattis@ante.org|Slovenia
Geoffrey Charles|magna@metus.co.uk|Sint Maarten
Julian Rodriguez|convallis.dolor@elitpellentesque.net|Luxembourg
Chase Mason|sed.dolor.Fusce@quam.ca|Ecuador
Murphy Sparks|a.sollicitudin.orci@lacusQuisque.org|Togo
Sasha Rios|Donec@musAeneaneget.net|Iran
Isaac Blake|Nullam@sapien.edu|Philippines
Jackson Morin|egestas@eget.net|Cape Verde
Karly Carey|Ut.sagittis.lobortis@ac.net|Lithuania
Rashad Branch|augue.scelerisque.mollis@id.net|Virgin Islands, United States
Tanisha Park|odio.Etiam.ligula@vitae.ca|Macedonia
Keely Winters|Vivamus.non@utnisi.org|Eritrea
Kuame Massey|magna@senectuset.co.uk|Bahrain
Paki Pearson|vel@maurisaliquameu.edu|Nigeria
Macon Cameron|egestas@parturient.edu|Belize
Brianna Day|ipsum.nunc@estarcu.com|San Marino
Griffin Aguirre|lorem.sit.amet@luctusaliquetodio.edu|Palau
Xyla Monroe|eu.ultrices.sit@feugiat.com|South Sudan
Bruno York|nisi.Mauris.nulla@Ut.co.uk|Sint Maarten
Austin Odom|quam@Proinsed.net|Anguilla
Freya Burke|aliquet.odio.Etiam@Nullamsuscipit.net|Sudan
Shoshana Gilmore|ligula@nibh.net|Andorra
Kaye Washington|hymenaeos.Mauris.ut@hendreritconsectetuercursus.edu|Kiribati
Melinda Pennington|a.purus@justoPraesentluctus.org|Côte D'Ivoire (Ivory Coast)
Arsenio Nunez|erat.Vivamus@ipsum.net|Congo (Brazzaville)
Tara Britt|Suspendisse@sitamet.com|Germany
Wyatt Mills|Nulla.semper@nibhsitamet.org|Gabon
Grady Ward|eget.magna.Suspendisse@cursusa.edu|Georgia
Elaine Cash|turpis@Maurisblanditenim.net|Saint Lucia
Moses Fletcher|et.magnis.dis@eusemPellentesque.com|Paraguay
Felicia George|Ut@dictumeu.co.uk|Chile
Megan Moss|Aliquam@commodotincidunt.edu|Mali
Danielle Hays|risus.odio@sit.edu|Ukraine
Unity Casey|Nunc@placeratCrasdictum.ca|Aruba
Gloria Mullins|dui@Vivamus.net|Wallis and Futuna
Kirk Petty|odio.sagittis@lacus.ca|United States
Delilah Butler|nonummy.ut@nondapibusrutrum.org|Côte D'Ivoire (Ivory Coast)
Amal Lawson|sit.amet.faucibus@semper.ca|South Sudan
Tarik Ramsey|eros.turpis@nonmagna.ca|Cambodia
Kamal Pate|eros@sit.ca|San Marino
Ingrid Bridges|enim.Etiam.gravida@lobortistellusjusto.net|Iraq
Indigo Bean|lacus.pede@nisi.ca|Maldives
Brielle Cook|metus.facilisis.lorem@et.edu|China
Carla Pate|lorem.fringilla@ametnullaDonec.org|Saint Lucia
Olga Bond|pede@sed.org|Canada
Len Clements|egestas@enim.org|Malta
Iliana Wynn|sed.dolor@ultriciessemmagna.ca|Seychelles
Flynn Avila|ut.molestie@velitdui.edu|Turkmenistan
Rudyard Curtis|Mauris@ullamcorpernislarcu.ca|Solomon Islands
Tad Spears|sem.Nulla.interdum@metusAliquam.co.uk|Malaysia
Stephanie Byers|magna.Phasellus@euodio.org|Latvia
Magee Snyder|ac.ipsum@dui.com|British Indian Ocean Territory
Hope Montoya|sem.Pellentesque.ut@sollicitudinorci.com|Serbia
Kato May|ullamcorper@vel.net|United Arab Emirates
Patrick Espinoza|aliquam@diameu.org|Indonesia
Barclay Gomez|mattis.Cras@egestasAliquam.co.uk|Laos
Xandra Webb|quis.massa@utpellentesque.org|Kyrgyzstan
Zane Henson|enim@etarcuimperdiet.org|Australia
Derek Sawyer|ultricies.ornare@malesuada.co.uk|Lesotho
Rowan Horne|eget.metus.In@MaurismagnaDuis.edu|British Indian Ocean Territory
Colette Whitehead|nunc@Phasellus.com|Latvia
Dakota Payne|mattis@Ut.com|Bolivia
Rana Shepherd|ligula@bibendumsed.com|Kiribati
Noel Powell|dictum.Phasellus.in@placeratCras.net|Jordan
Brennan Stark|varius@lobortisnisinibh.org|Argentina
Cheyenne Bryan|Nunc.sed@egetodioAliquam.net|Puerto Rico
Bradley Leach|tempor@egestasAliquamnec.org|Azerbaijan
Oscar Melendez|amet.faucibus.ut@risusDonecegestas.co.uk|Georgia
Coby Barber|Proin.sed@faucibusorciluctus.edu|Morocco
Aretha Hogan|orci.luctus@vestibulumlorem.net|Gambia
Delilah Rutledge|nec.eleifend@egestasAliquam.edu|Trinidad and Tobago
Sheila Goodwin|luctus.ipsum.leo@commodoat.co.uk|Côte D'Ivoire (Ivory Coast)
Neil Roach|pretium.et@egetvenenatis.org|Papua New Guinea
Abra Lawson|mollis.Duis.sit@Maecenasmalesuadafringilla.edu|Korea, South
Jaime Paul|nisi@Curabituregestas.co.uk|Viet Nam
Orson Vega|eget@Maecenas.edu|Niue
Abigail Houston|magnis@sapien.net|Libya
Aspen Robertson|mi.eleifend@tinciduntnibhPhasellus.ca|Mauritania
Clayton Leach|quis@auguescelerisque.net|Greenland
Lucius Curry|ac.ipsum@maurisutmi.co.uk|Pitcairn Islands
Ulysses Hammond|sem.molestie@metusInnec.edu|Eritrea
Phyllis Ruiz|Aliquam.nisl@nunc.ca|Qatar
Quinlan Whitney|orci.luctus@mauris.org|Netherlands
Emmanuel Ramos|eget@estarcu.co.uk|Nigeria
Katelyn Bishop|dolor.nonummy.ac@urnaUttincidunt.edu|Suriname
Piper Barron|cursus@nonummyutmolestie.ca|Tajikistan
Zeph Norris|amet.diam@velitQuisque.ca|Micronesia
Summer Avery|semper.Nam.tempor@etultricesposuere.co.uk|Liberia
Vaughan Flynn|malesuada.ut.sem@rutrumeuultrices.edu|Bonaire, Sint Eustatius and Saba
Charde Bonner|mattis.ornare.lectus@et.co.uk|Sint Maarten
Neil Robinson|malesuada.vel.venenatis@arcu.org|Russian Federation
Pearl Forbes|vitae@enim.co.uk|Turkey
Jacqueline Spears|sapien.gravida@ligulatortor.com|Monaco
Palmer Sandoval|vel@bibendumsed.co.uk|Timor-Leste
Odessa Pierce|Maecenas.ornare@vitaedolorDonec.net|Denmark